is
###########
LR @ @.   #
#  * *    #
###########
ie

c
W
c

os
###########
LR    .   #
#  *\*    #
###########
oe

F_LambdaMax 1