is
#########
#       #
#       #
#   R...#
#       #
#       #
#########
ie

c
RRRR
c

os
#########
#       #
#       #
#      R#
#       #
#       #
#########
oe
