is
#######
# *R* #
#     #
#######
ie

c
R
c

os
#######
#   R #
# *  *#
#######
oe