i
#######
# *R* #
#     #
#######
i

c
R
c

o
#######
# * R #
#    *#
#######
o