is
########
#R     #
#.     #
#      #
#W.    #
#      #
########
ie

Razors 1
Growth 3

c
WWWWWWWWWS
c

os
########
#R WW  #
#. WW  #
#WWWW  #
#W.WW  #
#WWWW  #
########
oe

F_Growth 3