is
########
#R     #
#      #
#      #
#W     #
#      #
########
ie

Growth 3

c
WWWWWWWWW
c

os
########
#RWWW  #
#WWWW  #
#WWWW  #
#WWWW  #
#WWWW  #
########
oe

F_Growth 3