is
########
#R     #
#      #
#      #
#W     #
#      #
########
ie

Growth 3

c
WWWWWWWWWS
c

os
########
#R WW  #
#  WW  #
#WWWW  #
#WWWW  #
#WWWW  #
########
oe

F_Growth 3