i
#######
#  R  #
#  *  #
#######
i

c
D
c

o
#######
#  R  #
#  *  #
#######
o