is
#######
#  R  #
#  .  #
#######
ie

c
D
c

os
#######
#     #
#  R  #
#######
oe