is
#########
#       #
#       #
#   *R* #
#       #
#       #
#########
ie

c
DDDDD
c

os
#########
#       #
#       #
#       #
#       #
#   *R* #
#########
oe