i
#########
#       #
#       #
#   R   #
#       #
#       #
#########
i

c
DDDDD
c

o
#########
#       #
#       #
#       #
#       #
#   R   #
#########
o