is
###############
#     *       #
#             #
#      R      #
#      \      #
#      \      #
#      \      #
#      \      #
#      \      #
#      \      #
#      \      #
#      L      #
###############
ie

c
DDDDDDDD
c

os
###############
#             #
#             #
#             #
#             #
#             #
#             #
#             #
#             #
#     *       #
#             #
#      O      #
###############
oe

F_Score 517
F_Moves 8
F_Lambda 7
F_LambdaMax 7
F_GameCondition WIN