flooding 4

is
########################
#.....................\#
#......*\   ...........#
#......*... ......* ...#
#..   \\... .*..... ...#
#.. ....... ....... ...#
#.. ....... .\\.... ...#   ######
#.  ....      .....\...#   #\\\\#
#\\\......... .........#   #....#
###########     R      ########*#####
          #.......... ........***\\\#
          #.......... ............**#
          #.......... ......... *.*\#
          #....\\.... ....\\..... ..L
          #.....................****#
          #........\*...............#
          #...........     .........#
          #.........................#
          ###########################
ie


Razors
Water 1
Flooding 20
Waterproof 10


c
RRRUURRUURUUUULLLLLLLLLLLLLLDULLLDDDRRLLLLLDDDLDRRRRRRRRRRURURRDDDDDDDRRRRDDRUURRRRRRRRRUURRRLUWRUUULLLRRRDDDLDDLLDRRRRRUDRRA
c

os
########################
#....                  #
#.... .     .......... #
#.... .*... ......* .. #
#.     *... .*..... .. #
#.  ....... ....... .  #
#.  .......    .... . .#   ######
#   ....       ....   .#   #    #
#           .  .... ...#   #... #
###########            ######## #####
          #... ...... ........  *\\\#
          #... ...... ......    ..**#
          #... ...... ......       \#
          #...               **** *RL
          #.......  ............****#
          #.......  *...............#
          #...........     .........#
          #.........................#
          ###########################
oe



Growth_F 0
Razors_F 0
Flooding_F 20
Score_F 826
Moves_F 124
Lambda_F 19
LambdaMax_F 23
CurMovesUnderWater_F 10
MaxMovesUnderWater_F 10
WaterLevel_F 7
GameCondition_F ABORTED

Score: 826 (124 moves, found 19/23 Lambdas, have 0 razors)
Status: Aborted
For 10 moves under water
7