contest5

is
############
#..........#
#.....*....#
#..\\\\\\..#
#.     ....#
#..\\\\\\\.#
#..\..    .#
#..\.. ....#
#..... ..* #
#..### ### #
#...R#\#\\.#
######L#####
ie



c
LLLURURUUUUURRRRRDRDLLLLRLLDDRRRRRRDDDLLRRUUULLDLLDDD
c

os
############
#..........#
#..... ....#
#..      ..#
#.     .  .#
#..       .#
#..  .    .#
#..        #
#.  .. * * #
#  ### ### #
#    # #   #
######O#####
oe




Razors_F 0
Score_F 1297
Moves_F 53
Lambda_F 18
LambdaMax_F 18
GameCondition_F WIN
