contest6

is
###############
#\\\.......** #
#\\#.#####...##
#\\#.....*##. #
#\#####\...## #
#\......####* #
#\.######* #.\#
#\.#. *...##.##
#\##. ..  *...#
#\...... L#.#.#
###########.#.#
#\..........#.#
##.##########.#
#R.#\.........#
###############
ie

c
RUULRRRRRRRRRRUUURRDDDDDLLLLLLLLLRRRRRRRRRUUUUULUURUUULULLULLLLLLDDRRRDULLLUULLLDRDLDDDDDDRRRRRRRR
c

os
###############
#             #
#  # ##### * ##
#  #    .*##* #
# ##### ...## #
# ......####  #
# .######* #  #
# .#. *...## ##
# ##. ..  * * #
#        O# # #
########### # #
#           # #
## ########## #
#  #          #
###############
oe



Razors_F 0
Score_F 1177
Moves_F 98
Lambda_F 17
LambdaMax_F 17
GameCondition_F WIN
