contest8

is
##############
#\\... ......#
###.#. ...*..#
  #.#. ... ..#
### #.   \ ..#
#. .#..... **#######
#.#\#..... ..\\\*. #
#*\\#.###. ####\\\ #
#\\.#.     ...## \ #
#\#.#..... ....# \ #
###.#..... ....#   ##
#\\.#..... ....#\   #
########.. ..###*####
#......... .........#
#......... ....***..#
#..\\\\\ # ####.....#
#........*R..\\\   .#
##########L##########
ie

Growth
Razors
Water
Flooding
Waterproof


c
UULRRRULUDDWLULLLLLLLDDRRRRRUUUURRDDDDDRRRRRRRRUUULLLLLRRRUURUUUULLULLLLLULULLLULUULLLLRRDDDDDDDLURLLDDUURRDDDDLLRRUUUUUUUUUURRRRRRDRDDDDDDDDDDDDDDD
c

os
##############
#         ...#
### #  ..  ..#
  # #  ... ..#
### #.     ..#
#.  #....    #######
#.# #..... **    . #
#   #.###. ####    #
# * #.     ...##   #
# # #..... ....#   #
### #..... ....#   ##
#   #...   ....#    #
######## .  .### ####
#..             *  .#
#.. .... *   ..*** .#
#..      # ####... .#
#........*        *.#
##########O##########
oe



Razors_F 0
Score_F 1952
Moves_F 148
Lambda_F 28
LambdaMax_F 28
GameCondition_F WIN
