contest9

is
        #L#######
        #*** \\ #
        #\\\ .. #
#########.##    ##########
#.......\ ..........*   .#
#*******\......#....#\\ .#
###\.\\\...**..#....... *#
#*****\\  .\\..##     #\.#
######### ....  ##########
        #       #
        ####*####
        #.......#
#########  \\\\*##########
#*\\  **#     *..*\ \\\\\#
#.\**\*** .....**.# \\##\#
#\R......     .\\.. \\\\\#
##########################
ie

Growth
Razors
Water
Flooding
Waterproof


c
RLLURURRRDLDRRRRRRRRRRRRRRRRRRRRUULLLDLULLRRDDLLLULLULULLLURLWRUUUULLLLLLURRULLLDLLRURRRRURRRRRRRRRRRDDDRRUURRDDULLLLLLUULLUUULLLLDLLRULU
c

os
        #O#######
        #       #
        #* * .. #
#########.##    ##########
#.......    *       *   .#
#**      ......#. . #   .#
###* **  ..  ..#.       *#
#*******   * ..##     # .#
######### .. .  ##########
        #       #
        #### ####
        #..  ...#
#########       ##########
#       #  ***  .        #
#     *   .....*  #   ## #
#*** ****      ***       #
##########################
oe



Razors_F 0
Score_F 3088
Moves_F 137
Lambda_F 43
LambdaMax_F 43
GameCondition_F WIN
