contest 10

is
#############################
#..........................\#
#..\\###...#....        ###.#
#..\*\\\.. #.... ..##\\..\#.#
#..\*\.... #.... ..#\#....#.#
#...\###.. #.... ....#....#.#
#... ..... ..... .####......#
#\\. #....           .......#
#... #..#. .....*\ ##.......#
#.#....... ...#..  ....######
#. ...#... ...#.\  ....#..* #
##........ ...#.. #....#.#\\#
#.....*... .....*\#\\.....*.#
#.***.* .......*\****.....#.#
#.\\\.. ................   .#
#.#####    .######    ##### #
#....\\.................... #
#....****...#.##.....\\\\..\#
#....\\\\...#.........*....\#
#....\\\\...#.\\.    #\###.\#
#....     ..#.... ...#\\\\. #
#........ ..#.... ...#..... #
#........         ........#R#
###########################L#
ie

Growth
Razors
Water
Flooding
Waterproof


c
UUUUUUUULLUUDDRRUUULRDLLLDDLLLDDDRRRRDLLULLDRDDRRRDLDLLLLLLUUULLLLDDLDLLLUULULLLLLURRRRRULLULLLLLLUURRRRUUULULUULLURRRUULUUURDRDRURRDDRRDRRRRRURRRRRUDLLUUURRRDRRRRDDDRRUUUUULLLLLLLLLLLDDDDDDRDDDLDLDURRDLDUURURRDDRRDDDDDDRDDDRRRRRDD
c

os
#############################
#...............            #
#..  ###...#....        ### #
#..      . #.... . ##     # #
#..    . . #.... . # #... # #
#..  ###   #...      #... # #
#... .....       .####...   #
#    #....           .......#
#   *#..#. .....*  ##.......#
#.# ...... ...#..  ....######
#. * .#... ...#.    ...#..  #
##..  .... ...#   # ...#.#  #
#....  ... ....   #   ..  * #
#.    * .......****** ..  # #
# ****. .............    *  #
# #####    .######    ##### #
#       ............. ..... #
#....     ..#.##.....     . #
#...      ..#........  *  . #
#...      ..#.       # ###. #
#....****  .#. ..  ..#    . #
#........  .#  ..  ..#      #
#........                .# #
###########################O#
oe



Razors_F 0
Score_F 3594
Moves_F 231
Lambda_F 51
LambdaMax_F 51
GameCondition_F WIN