ems1

is
#######
#L\\\##
##*  ##
##*  ##
##*  ##
##*  ##
##*  ##
##*  ##
##*  ##
##*  ##
##*  ##
##   ##
##   ##
##R  ##
## # ##
#\ # \#
## # ##
## # ##
## # ##
## # ##
#######
ie

c
DDLWWWWWWWWWWRUUURRDDDRLUUUUUUUUUUUUUULLL
c

os
#######
#O   ##
##   ##
##   ##
##   ##
##   ##
##   ##
##   ##
##   ##
##   ##
##   ##
##   ##
##   ##
## * ##
## # ##
#  #  #
##*#*##
##*#*##
##*#*##
##*#*##
#######
oe



Razors_F 0
Score_F 334
Moves_F 41
Lambda_F 5
LambdaMax_F 5
GameCondition_F WIN