ems2

is
#########
###***###
###***###
###***###
###***###
###***###
###***###
#  .**\\#
# # #*#\#
# # #*#\#
# # #*#\#
# # #*#\#
# # #*#\#
#    .#\#
###   **#
### R \\#
###   #L#
###   ###
###   ###
###   ###
###   ###
###   ###
###   ###
#########
ie



c
RRRLURUUUUUUULA
c

os
#########
###***###
###***###
###***###
###***###
###***###
###***###
#  .**R #
# # #*# #
# # #*# #
# # #*# #
# # #*# #
# # #*# #
#    .# #
###     #
###    *#
###   #O#
###   ###
###   ###
###   ###
###   ###
###   ###
###  *###
#########
oe




Razors_F 0
Score_F 486
Moves_F 14
Lambda_F 10
LambdaMax_F 10
GameCondition_F ABORTED
