ems3v2

is
################
#\.****####\#*##
#\.\\\\.***...##
##*####.#*###..#
#\.R....#...##\#
#\ ####...#.#*.#
#\ **######.#..#
##...\\\\\\...##
#L.#\########.##
################
ie

Growth
Razors
Water
Flooding
Waterproof


c
LLDDURUUULURDRRRRRDDDRRURRDDDLLLLLLRRRRRRRRURUUULULLUDLLLLDDLLLLLLDDA
c

os
################
#      #### # ##
#  ****       ##
## #### #*###* #
#       #*  ## #
#  ####* *# #  #
#R***###### #  #
##...        *##
#L.#\########.##
################
oe


Razors_F 0
Score_F 782
Moves_F 68
Lambda_F 17
LambdaMax_F 18
GameCondition_F ABORTED
