ems4

is
#########
#*     L#
#\      #
#\\     #
##\\    #
###\\   #
####\\  #
#####\\ #
####### #
# #*#*# #
#  * *  #
# #*#*# #
#  * *  #
# #*#*# #
# R* *  #
# #*#*# #
#  * *  #
# #*#*# #
#  * *  #
# #*#*# #
#  * *  #
###*#*#.#
#\. . #\#
### # ###
### # ###
##  #  ##
##  #  ##
##  #  ##
##  #  ##
##  #  ##
#########
ie

c
LDDDDDDRRRRRRDDUULWWRUUUUUUUUUUUUULLULULULULUA
c

os
#########
#      L#
#R      #
#       #
##      #
###     #
####    #
#####   #
####### #
# # # # #
#       #
# # # # #
#       #
# # # # #
#       #
# # # # #
#       #
# # # # #
#       #
# # # # #
#       #
###*#*# #
#\.*.*#*#
###*#*###
###*#*###
## *#* ##
##**#**##
##**#**##
##**#**##
##**#**##
#########
oe


Razors_F 0
Score_F 55
Moves_F 45
Lambda_F 12
LambdaMax_F 13
GameCondition_F ABORTED
