ems5

is
###################
#*************   ##
##***********# * ##
###*********##.*.##
####*******####*###
#####*****#####*###
######***######*###
#######*#######*###
###### * ######*###
#\     .      #*###
#\     \      #*###
#\     **     #*###
#\     ##     #*###
#\            #*###
#\    \  \    #*###
#\    ** **   #*###
#\    ## ##   #*###
#\            #*###
#\   \  \  \  #*###
#R   ** ** ** #*\##
#### ## ## ## #*###
###L           . ##
#### ## ## ## ##  #
###  #  ##  #  #  #
###  #  ##  #  #  #
###  #  ##  #  #  #
###################
ie

c
UUUUUUUUUURRRDRRRRRDDDDLLLLDDDDRRRRRRRRDDDRRRDDUULLLRRRWLLWRRWLLWRRWLLWRRWLLWRRWLLWRRWLLLLLRRRRRWLLLLLLRRRRRLLLRLRUUULUULUULUUULULULLUWWWWWWWWWWWWWWWRLWWWRWWLWWWWWWWWWWWWWWWWWWWWWWWWWWWRUUURUURURURRRRRDDLA
c

os
###################
#*               ##
##*         *#*  ##
###*       *##R .##
####*     *#### ###
#####*   *##### ###
######* *###### ###
####### ####### ###
######   ###### ###
#             # ###
#             # ###
#      **     # ###
#      ##     # ###
#             # ###
#             # ###
#     ** **   # ###
#     ## ##   # ###
#    *        # ###
#   ***       # ###
#  ******* ** #*\##
####*##*## ## #*###
###L*  *       **##
####*##*## ##*##* #
### *# *##  #* #**#
###**#**##  #**#**#
###**#**##**#**#**#
###################
oe


Razors_F 0
Score_F 596
Moves_F 204
Lambda_F 16
LambdaMax_F 17
GameCondition_F ABORTED
