beard2
is
##############################
#R...........................#
#.........................W..#
#..\\\\\\\\\\\\\\\\\\\\\\\\..#
#............................#
#..*****.*\...*...*...*****..#
#..*\....*\....*\*..*.\\*\\..#
#..*\....****..!*!......*....#
#..*\....*\....*\*..*...*....#
#..*\....*\...*...*.....*....#
#............................#
#..\\\\\\\\\\\\\\\\\\\\\\\\..#
#................ ..... .....#
#................      W....L#
##############################
ie

Growth 25
Razors 10
Flooding 20
Waterproof 10



c
DDRRRRRRRRRRRRRRRRRRRRRRRRRRDDDLLRDDDDDLLLLLLLLLLLLLLLLLLLLLLLRUUUUURRRRDUUWRRDRRRDDLLRDLLURRURRRLULURRDRURURRDDDDLRDDLLLUURURRRRRRULLUURRRRRSRRDDDDDDDDD
c

os
##############################
# ...........................#
# ........................W..#
#                    WWWWWWW.#
#................   .WWWWW   #
#..        ..     * .    WWW #
#..  ***          .     **W* #
#..  ...*     *      ****.W. #
#..**....**  *.* *  *...*.W. #
#..**....****.*. .W*....*.W. #
#...*...........  WW......W. #
#.. *           * *WWWWWWWW. #
#................*.....W.... #
#................*WWWWWW....O#
##############################
oe



Growth_F 25
Razors_F 11
Flooding_F 20
Score_F 4497
Moves_F 153
Lambda_F 62
LambdaMax_F 62
WaterLevel_F 7
CurMovesUnderWater_F 6
MaxMovesUnderWater_F 10
GameCondition_F WIN