ems5v2

is
###################
#*************   ##
##***********# * ##
###*********##.*.##
####*******####*###
#####*****#####*###
######***######*###
#######*#######*###
###### * ######*###
#\     .      #*###
#\     \      #*###
#\     **     #*###
#\     ##     #*###
#\            #*###
#\    \  \    #*###
#\    ** **   #*###
#\    ## ##   #*###
#\            #*###
#\   \  \  \  #*###
#R   ** ** ** #*\##
#### ## ## ## #*###
####           . ##
#### ## ## ## ## ##
##   ## #   #  #  #
## * L# #\  #  # *#
##   ## # \ # ##  #
## #### #  \# \#  #
###################
ie

Growth
Razors
Water
Flooding
Waterproof


c
UUUUUUUUUURRRDDDDDDDDDDDDRRRRRRDDDDRDLULURUUURRRDDDDDRLUUUUUUUUUUUUULLLLLLLUUUURLWWWWWWDWRLRLLLWWWWWWWWWWWWWWWWDDDDDDDDURRRDWRLLLLUUUURRRRRRRDDDDUUUUUUUUDDDDDRDDDRDDDRRLLLRUUUUUWA
c

os
###################
#*           *   ##
##*         *# * ##
###*       *##.*.##
####*     *####*###
#####*   *#####*###
######* *######*###
####### #######*###
######   ######*###
#             #*###
#             #*###
#      **     # ###
#      ##     #*###
#             #*###
#             #*###
#     ** **   #*###
#     ## ##  R#*###
#             #*###
#             #*###
#    ** ** ** #*\##
#### ## ## ## #*###
####      *    * ##
#### ##*##*##*## ##
##   ##*# * #* #  #
##   L#*#***#**#  #
## * ##*#***#*##  #
## ####*#***#* # *#
###################
oe


Score_F 822
Moves_F 178
Lambda_F 20
LambdaMax_F 21
GameCondition_F ABORTED
