ems6

is
###########################
#............R............#
#.####.######L######.####.#
#.####.#*#########*#.####.#
#.####..\#*******#\..####.#
#.######..\\\\\\\..######.#
#.####*######.######*####.#
#.####\.....#.#.....\####.#
#......####.#.#.####....#.#
#####.#***#.#.#.#***#.#.#.#
#......\\\..#.#..\\\..#.#.#
#.#########*****#####.#.#.#
#..........\\\\\......#...#
###########################
ie

Growth
Razors
Water
Flooding
Waterproof


c
RRRRRRRDDDLLRRUUULLLLLLLLLLLLLLDDDRRLLUUULLLLLDDDDDDDRRRRRURRRRRDDDLLLLLLUULLLLUUUUUUURRRRRRRRRRRRRRRRRRRRRRRRDDDDDDDDDDDLLUUUULLLULLRRUDLLLLLDDDRRRRRRDDLLLLLLLLLLLLLLLLLLLLUURRRA
c

os
###########################
#                         #
# #### ######L###### #### #
# #### # ######### # #### #
# ####  *#*******#*  #### #
# ######..\\\\\\\..###### #
# #### ######.###### #### #
# ####      #.#      #### #
#     *#### #.# ####*   # #
##### #   # #.# #   #.# # #
#   R  ***  #.#  ***  # # #
# #########     ##### # # #
#          *****      #   #
###########################
oe


Score_F 572
Moves_F 178
Lambda_F 15
LambdaMax_F 22
GameCondition_F ABORTED
