trampoline 3


is
#######################################
#****................#..1...\\\\\\\B..#
#R.......##############################
#.. ..................................#
#.. ........       \            ......#
#.. .*. ....**.*...#....... ..........#
#.. ... ....\\\\...#.A..... ..........#
#.. ... ....\ .....#.......    *  \\..#
#.. ... ....\......#....... ..........#
#.. ... ....\......#....... ..........#
#.. ... ...........#................**#
#..\\\\\...........#................\\#
########### ############## ############
#...*.................................#
#....*..................        ......#
#... .*....*.............. ..... .....#
#....*2*........########.. ..... .....L
#...*...*.......#\\\#..... ...*.......#
#.....\\\.......#\\\#....**..***......#
#....    .......#\\\#*................#
#...............#\\\#*...**...*.......#
#...............#.....................#
######       ############## ### #######
#\\\\\\\\\\\\\\\\\\\\\\\\\\\\\\\\\\\\\#
#######################################
ie


Trampoline A targets 1
Trampoline B targets 2
Growth 0
Razors 0
Flooding 0



c
RRRRDDLDDDDDDDLRRRRRRRRUDDDDLDLLDRRUURUUURUUUUURRRRURURRRRRDRRRRRRRRRRRRRRRDLDLLDDDRDRRLULLLLLLLLLLLLLLLUUUURRRRRRRRRRRRRRDDLLLDDDDDLLLLLRRRRRRRRRRRRRRRRRRRRRRRRRRRRRRRRRRRRLLLLLLLLLLUULLLLLLLLUUUULLDRDLDRDRRRRRURRRRDRRRRRRRRRUUUUURR
c

os
#######################################
#    ................#..            ..#
#** * ...##############################
#.. . ................................#
#..   ......                    ......#
#..  *. ....  .   .#..                #
#..  .. ....   * ..#. ..... ........  #
#..  .. .... *.....#. .....    *     .#
#..  .. .... ......#. ..... ...... ...#
#..  .. .... ......#. ..... ...... ...#
#..  .. ...  ......#.                 #
#..*        *......#...............* *#
########### ############## ############
#...*...... ..........................#
#....*....  ............        ......#
#... . .   *.............. ..... .....#
#....**   *.....########.. ..... ...  O
#...*...  ......#   #..... ...*..... .#
#.....    ......#   #....**..***.... .#
#....   *.......#   # .............. .#
#..... .........#   # .     .. ..... .#
#..... .........#.   *  ***   *      .#
######       ############## ### #######
#                                     #
#######################################
oe



Growth_F 0
Razors_F 0
Flooding_F 0
Score_F 5467
Moves_F 233
Lambda_F 76
LambdaMax_F 76
WaterLevel_F 0
GameCondition_F WIN