is
############
#R         #
#          #
#  @       #
#  @       #
#  *       #
############
ie

c
W
c

os
############
#R         #
#          #
#          #
#   @      #
#  *\      #
############
oe