is
#################
LR            @@#
#             @ #
#################
ie

c
W
c

os

#################
LR              #
#            \@\#
#################
oe
