is
###############
#     *       #
#             #
#      R      #
#      \      #
#      \      #
#      \      #
#      \      #
#      \      #
#      \      #
#      \      #
#             #
###############
ie

c
DDDDDDDL
c

os
###############
#             #
#             #
#             #
#             #
#             #
#             #
#             #
#             #
#     *       #
#     R       #
#             #
###############
oe

Score_F 167
Moves_F 8
Lambda_F 7
LambdaMax_F 7
GameCondition_F RB_CRUSHED