is
#####L######
#....R....A#
#..........#
#\.  #@\ ..#
#\...#*  ###
#\.........#
#\..*.@....#
####@@.  ..#
#....#.. ###
#....#..**.#
#.1..#  .\\#
############
ie

Growth 0
Razors 0
Flooding 0


c
LLLLDDDDDRRURRRRDRDDLLURULDDDDRRRRULLLLUUUUUURUURRRRRUULDDWRLUURURRDDDUUUUUUUUULU
c

os
#####O######
#          #
# ....  ...#
# .  #   ..#
# ...#   ###
# .     ...#
#    .   ..#
####     ..#
#..  #   ###
#..  #     #
#.  *# *** #
############
oe

F_Growth 0
F_Razors 0
F_Flooding 0
F_Score 744
F_Moves 81
F_Lambda 11
F_LambdaMax 11
F_WaterLevel 0
