i
#######
# *R* #
#.   ##
#######
i

c
L
c

o
#######
#*R * #
#.   ##
#######
o
