i
#########
#       #
#       #
#   R   #
#       #
#       #
#########
i

c
LLLLLL
c

o
#########
#       #
#       #
#R      #
#       #
#       #
#########
o