is
#########
#       #
#       #
#   R   #
#       #
#       #
#########
ie

c
LLLLLL
c

os
#########
#       #
#       #
#R      #
#       #
#       #
#########
oe