##########
#**  \\\\#
#.R..    #
# \  ..*\#
#    ..* #
####   # #
#\\... # L
#\\. ... #
#\\.     #
##########

Growth 15
Razors 0
