#############################
#R                          #
# @   @  @                @ #
#...........................#
#                           #
#                           #
#                           #
#                           #
#                           #
#                           #
##################L##########

Growth 0