#######
#L\\\##
##*  ##
##*  ##
##*  ##
##*  ##
##*  ##
##*  ##
##*  ##
##*  ##
##*  ##
##   ##
##   ##
##R  ##
## # ##
#\ # \#
## # ##
## # ##
## # ##
## # ##
#######

Growth 15
Razors 0