 #####################################################                                                    
##        L                                          ##
#   ###   R   #   # #  #    # #  #     ####   ####    #
#  #   #  #   #   ## ## #   ## ## #   #       #   #   #
#   #     #   #   #  #  #   #  #  #   #       #   #   #
#    #    #   #   #  #  #   #  #  #   #####   ####    #
#     #   #   #   #  #  #   #  #  #   #       #   #   #
#  #   #  #   #   #  #  #   #  #  #   #       #   #   #
#   ###   \###    #  #  #   #  #  #    ####   #   #   #
#                                                     #
#   ###    ###    ####     ####    #     # #  #       #
#  #   #  #   #   #   #   #       # #    ## ## #      #
#   #     #       #   #   #      #   #   #  #  #      #
#    #    #       ####    #####  #####   #  #  #      #
#     #   #       #   #   #      #   #   #  #  #      #
#  #   #  #   #   #   #   #      #   #   #  #  #      #
#   ###    ###    #   #    ####  #   #   #  #  #      #
##                                                   ##
 #####################################################                                                    
