is
###########
#  @ @.   #
#  * *    #
#  ...    #
#    R    #
###########
ie

c
WLUU
c

os
###########
#     .   #
#  *R*    #
#  . .    #
#         #
###########
oe

F_LambdaMax 1
F_Lambda 1
F_Moves 4