is
#######
# *R* #
#     #
#######
ie

c
S
c

os
#######
#  R  #
# * * #
#######
oe