is
############
#R         #
#          #
#  *       #
#  @       #
#  *       #
############
ie

c
SS
c

os
############
#R         #
#          #
#  *       #
#  @       #
#  *       #
############
oe