#########
#       #
#       #
#   R   #
#       #
#       #
#########
