i
#######
#  #  #
#  R  #
#######
i

c
U
c

o
#######
#  #  #
#  R  #
#######
o