is
#######
#  *  #
#  R  #
#######
ie

c
U
c

os
#######
#  *  #
#  R  #
#######
oe