is
#########
#   .   #
#   .   #
#   R   #
#       #
#       #
#########
ie

c
UUUUUU
c

os
#########
#   R   #
#       #
#       #
#       #
#       #
#########
oe