is
#######
# *R* #
#.   ##
#######
ie

c
L
c

os
#######
#*R   #
#.  *##
#######
oe
